#############
#@.....k...!#
#...........#
#...........#
#..l........#
#...........#
#...........#
#############
